            R     640 480 
     SO textures/path_to_the_south_texture.xpm 
   S              textures/sprite.xpm   

EA textures/path_to_the_east_texture.xpm               


      NO           textures/path_to_the_north_texture.xpm  


      WE textures/path_to_the_west_texture.xpm  
    F 000062       , 0000062   , 000000062                  
                          C 62,150,230
                          
                                                        1111112
                                                        11020111111111
                11111111111111111                       11000000000001
                100000000000000011111111111111111111111111020020020021
                102000002000002000000000000000000000000000000000000001
                100000000000000011111111111111111001111111111111011111
                10002000200020001               1001           101
                10000000000000001               1001           101111111111111111    
                10202020002020201               1001           100000000000000001
                10000000000000001           111110011111       111111111111111101
                10002000200200001           100000000001                      101
                10000000000000001           100000000001                      101
                10200000200002001111111111111000200200011111111111111111111111101
                100000000000000000000000000000000E0000000000000000000000000000001
                11111011111111111111111111111000200200011111111111111111111111101
                    101                     100000000001                      101
                11111011111111111           100000000001                      101
                10000000000000001           111110011111                      101
                10200000200000201               1001                          101
                10000000000000001111111111111111100111111111111111111111111111101
                10002000200020000000000000000000000000000000000000000000000000001
                10000000000000001111111111111111111111111111111111111111111111111
                10202020002020201
                10000000000000001                                                                   1111
                10002000200200001                                                                   1001
                11111111111111111                                                                   1111
111111
1111
111
1